COLUMNS: 8
ROWS: 8
TIME: 160
TILE_TYPES: 10

// Grid Layout
01 02 03 04 04 03 02 01
05 06FZ 07 07 06FZ 05 01 01
08 09 10 01 01 10 09 08
00 00 00 00 00 00 00 00
01 02 03 04 05 06 07 08
01 02 03 04 05 06 00 03
01 02 03 04 05 06 02 00
01 02 03 04 05 06 00 03