// Level 1: Những Bước Đầu Tiên
COLUMNS: 8
ROWS: 8
TIME: 90
TILE_TYPES: 6

// Grid Layout (y từ 0 đến 11)
01 01 02 02 03 03 04 04
05 05 06 06 00 00 00 02
01 02 03 04 05 06 01 04
01 02 03 04 05 06 02 02
01 02 03 04 05 06 01 04
01 02 03 04 05 06 00 03
01 02 03 04 05 06 02 00
01 02 03 04 05 06 00 03

