COLUMNS: 8
ROWS: 8
TIME: 150
TILE_TYPES: 8

// Grid Layout
01 02 03 04 04 03 02 01
05 06 07 08 08 07 06 05
ST ST ST BB BB ST ST ST
01 02 05 06 06 05 02 01
03 04 07 08 08 07 04 03
01 02 03 04 05 06 07 08
00 05 01 05 03 04 03 01
04 00 08 02 08 00 02 00