// Level 1: Những Bước Đầu Tiên
COLUMNS: 8
ROWS: 12
TIME: 90
TILE_TYPES: 6
GRAVITY: NONE

// Grid Layout (y từ 0 đến 11)
00 00 00 00 00 00 00 00
00 00 00 00 00 00 00 00
00 01 01 00 02 02 00 00
00 03 00 00 00 00 03 00
00 04 04 00 00 00 00 00
00 05 05 06 06 00 00 00
00 00 00 00 00 00 00 00
00 00 00 00 00 00 00 00
00 00 00 00 00 00 00 00
00 00 00 00 00 00 00 00
00 00 00 00 00 00 00 00
00 00 00 00 00 00 00 00